30 30
Board placed by Designer:
-1 -1 -1 -1 -1 -1 -1 -1 -1 -1 -1 -1 -1 -1 -1 -1 -1 -1 -1 -1 -1 -1 -1 -1 -1 -1 -1 -1 -1 -1 
-1 -1 -1 -1 -1 -1 -1 -1 -1 -1 -1 -1 -1 -1 -1 -1 -1 -1 -1 -1 -1 -1 -1 -1 -1 -1 -1 -1 -1 -1 
-1 -1 -1 -1 -1 -1 -1 -1 -1 -1 -1 -1 -1 -1 -1 -1 -1 -1 -1 -1 -1 -1 -1 -1 -1 -1 -1 -1 -1 -1 
-1 -1 -1 -1 -1 -1 -1 -1 -1 -1 -1 -1 -1 -1 -1 -1 -1 -1 -1 -1 -1 -1 -1 -1 -1 -1 -1 -1 -1 -1 
-1 -1 -1 -1 -1 -1 -1 -1 -1 -1 -1 -1 -1 -1 -1 -1 -1 -1 -1 -1 -1 -1 -1 -1 -1 -1 -1 -1 -1 -1 
-1 -1 -1 -1 -1 -1 -1 -1 -1 -1 -1 -1 -1 -1 -1 -1 -1 -1 -1 -1 -1 -1 -1 -1 -1 -1 -1 -1 -1 -1 
-1 -1 -1 -1 -1 -1 -1 -1 -1 -1 -1 -1 -1 -1 -1 -1 -1 -1 -1 -1 -1 -1 -1 -1 -1 -1 -1 -1 -1 -1 
-1 -1 -1 -1 -1 -1 -1 -1 -1 -1 -1 -1 -1 -1 -1 -1 -1 -1 -1 -1 -1 -1 -1 -1 -1 -1 -1 -1 -1 -1 
-1 -1 -1 -1 -1 -1 -1 -1 -1 -1 -1 -1 -1 -1 -1 -1 -1 -1 -1 -1 -1 -1 -1 -1 -1 -1 -1 -1 -1 -1 
-1 -1 -1 -1 -1 -1 -1 -1 -1 -1 -1 -1 -1 -1 -1 -1 -1 -1 -1 -1 -1 -1 -1 -1 -1 -1 -1 -1 -1 -1 
-1 -1 -1 -1 -1 -1 -1 -1 -1 -1 -1 -1 -1 -1 -1 -1 -1 -1 -1 -1 -1 -1 -1 -1 -1 -1 -1 -1 -1 -1 
-1 -1 -1 -1 -1 -1 -1 -1 -1 -1 16 16 -1 16 16 -1 -1 -1 -1 -1 -1 -1 -1 -1 -1 -1 -1 -1 -1 -1 
-1 -1 -1 -1 -1 -1 -1 -1 -1 -1 16 4 4 4 16 -1 -1 -1 -1 -1 -1 -1 -1 -1 -1 -1 -1 -1 -1 -1 
-1 -1 -1 -1 -1 -1 -1 -1 -1 -1 -1 4 0 4 -1 -1 -1 -1 -1 -1 -1 -1 -1 -1 -1 -1 -1 -1 -1 -1 
-1 -1 -1 -1 -1 -1 -1 -1 -1 -1 16 4 4 4 16 -1 -1 -1 -1 -1 -1 -1 -1 -1 -1 -1 -1 -1 -1 -1 
-1 -1 -1 -1 -1 -1 -1 -1 -1 -1 16 16 -1 16 16 -1 -1 -1 -1 -1 -1 -1 -1 -1 -1 -1 -1 -1 -1 -1 
-1 -1 -1 -1 -1 -1 -1 -1 -1 -1 -1 -1 -1 -1 -1 -1 -1 -1 -1 -1 -1 -1 -1 -1 -1 -1 -1 -1 -1 -1 
-1 -1 -1 -1 -1 -1 -1 -1 -1 -1 -1 -1 -1 -1 -1 -1 -1 -1 -1 -1 -1 -1 -1 -1 -1 -1 -1 -1 -1 -1 
-1 -1 -1 -1 -1 -1 -1 -1 -1 -1 -1 -1 -1 -1 -1 -1 -1 -1 -1 -1 -1 -1 -1 -1 -1 -1 -1 -1 -1 -1 
-1 -1 -1 -1 -1 -1 -1 -1 -1 -1 -1 -1 -1 -1 -1 -1 -1 -1 -1 -1 -1 -1 -1 -1 -1 -1 -1 -1 -1 -1 
-1 -1 -1 -1 -1 -1 -1 -1 -1 -1 -1 -1 -1 -1 -1 -1 -1 -1 -1 -1 -1 -1 -1 -1 -1 -1 -1 -1 -1 -1 
-1 -1 -1 -1 -1 -1 -1 -1 -1 -1 -1 -1 -1 -1 -1 -1 -1 -1 -1 -1 -1 -1 -1 -1 -1 -1 -1 -1 -1 -1 
-1 -1 -1 -1 -1 -1 -1 -1 -1 -1 -1 -1 -1 -1 -1 -1 -1 -1 -1 -1 -1 -1 -1 -1 -1 -1 -1 -1 -1 -1 
-1 -1 -1 -1 -1 -1 -1 -1 -1 -1 -1 -1 -1 -1 -1 -1 -1 -1 -1 -1 -1 -1 -1 -1 -1 -1 -1 -1 -1 -1 
-1 -1 -1 -1 -1 -1 -1 -1 -1 -1 -1 -1 -1 -1 -1 -1 -1 -1 -1 -1 -1 -1 -1 -1 -1 -1 -1 -1 -1 -1 
-1 -1 -1 -1 -1 -1 -1 -1 -1 -1 -1 -1 -1 -1 -1 -1 -1 -1 -1 -1 -1 -1 -1 -1 -1 -1 -1 -1 -1 -1 
-1 -1 -1 -1 -1 -1 -1 -1 -1 -1 -1 -1 -1 -1 -1 -1 -1 -1 -1 -1 -1 -1 -1 -1 -1 -1 -1 -1 -1 -1 
-1 -1 -1 -1 -1 -1 -1 -1 -1 -1 -1 -1 -1 -1 -1 -1 -1 -1 -1 -1 -1 -1 -1 -1 -1 -1 -1 -1 -1 -1 
-1 -1 -1 -1 -1 -1 -1 -1 -1 -1 -1 -1 -1 -1 -1 -1 -1 -1 -1 -1 -1 -1 -1 -1 -1 -1 -1 -1 -1 -1 
-1 -1 -1 -1 -1 -1 -1 -1 -1 -1 -1 -1 -1 -1 -1 -1 -1 -1 -1 -1 -1 -1 -1 -1 -1 -1 -1 -1 -1 -1 
Board auto-completed by AI
4 4 4 4 16 4 4 4 4 4 4 4 4 4 16 4 16 16 4 4 4 4 4 4 16 4 12 4 4 4 
4 16 4 4 4 16 4 6 16 16 16 3 16 4 2 4 12 4 16 4 16 4 16 3 16 4 16 3 16 4 
6 16 16 3 16 4 4 4 4 4 16 4 4 16 16 16 16 4 2 4 4 4 12 4 4 4 4 4 4 16 
4 16 16 4 16 16 4 4 4 3 16 4 4 4 4 4 4 4 16 4 4 4 16 4 4 4 4 4 4 16 
4 4 12 3 16 16 3 16 4 4 4 4 4 4 0 4 4 6 4 6 16 10 4 16 4 4 4 4 4 4 
3 16 16 4 12 4 4 4 4 4 4 6 16 4 4 4 4 4 4 4 16 16 16 16 16 3 16 4 4 4 
4 16 4 16 16 4 4 4 16 16 4 4 12 4 4 4 4 4 4 4 4 4 16 4 16 4 16 4 6 16 
3 16 16 16 4 16 16 4 4 4 4 4 16 4 4 16 16 16 16 3 16 4 4 4 4 4 4 4 4 16 
4 16 16 16 4 16 4 16 4 4 4 4 2 4 4 4 4 16 16 4 16 16 16 4 16 4 4 16 16 16 
4 4 4 16 3 16 3 16 4 16 16 3 16 4 4 4 16 4 2 4 4 4 2 16 16 16 16 16 16 16 
4 4 4 2 4 16 4 4 4 4 2 4 4 4 4 16 16 16 16 4 4 4 16 16 4 16 16 16 4 4 
4 4 4 16 4 4 16 4 4 16 -1 -1 3 -1 -1 16 4 4 2 4 4 4 16 16 16 16 4 4 4 4 
4 4 4 4 4 4 4 4 16 4 -1 -1 -1 -1 -1 4 4 4 6 16 16 16 4 4 4 4 4 4 4 4 
4 6 4 4 4 4 6 4 4 4 12 -1 -1 -1 12 4 4 4 4 12 4 4 4 4 16 16 3 16 16 3 
4 4 4 16 16 16 4 4 4 4 -1 -1 -1 -1 -1 16 4 4 16 16 16 4 4 4 4 4 4 16 4 4 
4 4 4 16 16 16 16 16 16 3 -1 -1 16 -1 -1 16 4 4 2 4 4 4 4 4 0 6 4 2 4 16 
16 3 16 4 4 12 4 16 4 4 16 16 16 16 4 4 16 4 16 16 16 16 16 4 4 4 6 16 16 16 
4 4 4 16 3 16 4 16 4 4 4 2 4 2 4 4 16 3 16 16 4 2 4 4 16 4 4 4 2 4 
16 4 4 4 4 2 4 4 16 3 16 16 16 16 16 3 16 4 2 4 4 16 16 16 16 4 0 6 16 3 
16 3 16 16 3 16 4 4 4 4 12 4 2 4 4 4 4 4 16 16 16 16 4 2 4 4 4 4 2 4 
4 4 2 4 4 4 4 16 16 4 16 16 16 4 4 4 16 4 2 4 4 4 4 16 16 4 4 4 16 16 
4 16 16 3 16 16 4 4 2 4 4 4 4 4 4 4 4 4 16 16 16 4 4 4 4 4 4 6 16 4 
16 4 4 4 4 16 16 16 16 3 16 4 4 4 4 4 4 4 4 16 16 3 16 4 4 4 4 4 12 4 
16 16 16 16 16 4 4 4 2 4 4 4 4 4 16 4 4 4 4 4 4 4 12 4 4 4 4 4 16 4 
4 2 4 2 4 16 16 3 16 4 4 4 4 4 16 16 4 4 4 4 4 4 16 16 16 16 4 16 16 4 
4 16 16 16 4 4 4 4 16 4 4 4 4 4 2 4 16 4 4 4 16 16 16 16 16 16 16 4 2 4 
3 16 16 16 4 4 4 16 16 3 16 3 16 16 16 4 4 4 4 4 4 4 2 4 4 4 2 4 16 16 
4 4 4 16 4 4 4 4 4 4 4 4 4 4 16 4 4 6 4 4 16 4 16 16 16 16 16 3 16 16 
16 3 16 4 16 16 16 16 16 4 16 16 16 3 16 16 4 4 4 4 4 4 4 4 16 16 16 4 4 4 
2 4 4 4 2 4 4 4 4 16 16 16 16 4 4 4 4 16 16 3 16 4 16 16 16 4 4 4 4 4 

Asset Legend:
0 Chest
1 Column
2 Door Horizontal
3 Door Vertical
4 Floor Empty
5 Large Bush Square
6 Monster
7 SmallBush Round
8 SmallBush Square
9 Stairs Down
10 Stairs Up
11 Statue
12 Trap
13 Tree
14 Wall Cross
15 Wall Horizontal
16 Wall Thick
17 Wall Vertical
