30 30
Board placed by Designer:
-1 -1 -1 -1 -1 -1 -1 -1 -1 -1 -1 -1 -1 -1 -1 -1 -1 -1 -1 -1 -1 -1 -1 -1 -1 -1 -1 -1 -1 -1 
-1 -1 -1 -1 -1 -1 -1 -1 -1 -1 -1 -1 -1 -1 -1 -1 -1 -1 -1 -1 -1 -1 -1 -1 -1 -1 -1 -1 -1 -1 
-1 -1 -1 -1 -1 -1 -1 -1 -1 -1 -1 -1 -1 -1 -1 -1 -1 -1 -1 -1 -1 -1 -1 -1 -1 -1 -1 -1 -1 -1 
-1 -1 -1 -1 -1 -1 -1 -1 -1 -1 -1 -1 -1 -1 -1 -1 -1 -1 -1 -1 -1 -1 -1 -1 -1 -1 -1 -1 -1 -1 
-1 -1 -1 -1 -1 -1 -1 -1 -1 -1 -1 -1 -1 -1 -1 -1 -1 -1 -1 -1 -1 -1 -1 -1 -1 -1 -1 -1 -1 -1 
-1 -1 -1 -1 -1 -1 -1 -1 -1 -1 -1 -1 -1 -1 -1 -1 -1 -1 -1 -1 -1 -1 -1 -1 -1 -1 -1 -1 -1 -1 
-1 -1 -1 -1 -1 -1 -1 -1 -1 -1 -1 -1 -1 -1 -1 -1 -1 -1 -1 -1 -1 -1 -1 -1 -1 -1 -1 -1 -1 -1 
-1 -1 -1 -1 -1 -1 -1 -1 -1 -1 -1 -1 -1 -1 -1 -1 -1 -1 -1 -1 -1 -1 -1 -1 -1 -1 -1 -1 -1 -1 
-1 -1 -1 -1 -1 -1 16 16 16 3 16 16 16 3 16 16 16 -1 -1 -1 -1 -1 -1 -1 -1 -1 -1 -1 -1 -1 
-1 -1 -1 -1 -1 -1 16 4 4 4 4 4 4 4 4 4 16 -1 -1 -1 -1 -1 -1 -1 -1 -1 -1 -1 -1 -1 
-1 -1 -1 -1 -1 -1 16 4 16 16 16 3 16 16 16 4 16 -1 -1 -1 -1 -1 -1 -1 -1 -1 -1 -1 -1 -1 
-1 -1 -1 -1 -1 -1 16 4 2 4 4 12 4 4 2 4 16 -1 -1 -1 -1 -1 -1 -1 -1 -1 -1 -1 -1 -1 
-1 -1 -1 -1 -1 -1 16 4 16 4 4 4 4 4 16 4 16 -1 -1 -1 -1 -1 -1 -1 -1 -1 -1 -1 -1 -1 
-1 -1 -1 -1 -1 -1 16 4 16 4 4 4 4 4 16 6 2 -1 -1 -1 -1 -1 -1 -1 -1 -1 -1 -1 -1 -1 
-1 -1 -1 -1 -1 -1 16 6 16 4 16 0 16 4 16 4 16 -1 -1 -1 -1 -1 -1 -1 -1 -1 -1 -1 -1 -1 
-1 -1 -1 -1 -1 -1 16 4 16 4 4 4 4 4 16 4 16 -1 -1 -1 -1 -1 -1 -1 -1 -1 -1 -1 -1 -1 
-1 -1 -1 -1 -1 -1 2 12 2 4 4 4 4 4 2 4 16 -1 -1 -1 -1 -1 -1 -1 -1 -1 -1 -1 -1 -1 
-1 -1 -1 -1 -1 -1 16 4 16 3 16 16 16 16 16 4 16 -1 -1 -1 -1 -1 -1 -1 -1 -1 -1 -1 -1 -1 
-1 -1 -1 -1 -1 -1 16 4 4 4 4 4 4 4 4 4 16 -1 -1 -1 -1 -1 -1 -1 -1 -1 -1 -1 -1 -1 
-1 -1 -1 -1 -1 -1 16 16 16 16 16 3 16 16 16 16 16 -1 -1 -1 -1 -1 -1 -1 -1 -1 -1 -1 -1 -1 
-1 -1 -1 -1 -1 -1 -1 -1 -1 -1 -1 -1 -1 -1 -1 -1 -1 -1 -1 -1 -1 -1 -1 -1 -1 -1 -1 -1 -1 -1 
-1 -1 -1 -1 -1 -1 -1 -1 -1 -1 -1 -1 -1 -1 -1 -1 -1 -1 -1 -1 -1 -1 -1 -1 -1 -1 -1 -1 -1 -1 
-1 -1 -1 -1 -1 -1 -1 -1 -1 -1 -1 -1 -1 -1 -1 -1 -1 -1 -1 -1 -1 -1 -1 -1 -1 -1 -1 -1 -1 -1 
-1 -1 -1 -1 -1 -1 -1 -1 -1 -1 -1 -1 -1 -1 -1 -1 -1 -1 -1 -1 -1 -1 -1 -1 -1 -1 -1 -1 -1 -1 
-1 -1 -1 -1 -1 -1 -1 -1 -1 -1 -1 -1 -1 -1 -1 -1 -1 -1 -1 -1 -1 -1 -1 -1 -1 -1 -1 -1 -1 -1 
-1 -1 -1 -1 -1 -1 -1 -1 -1 -1 -1 -1 -1 -1 -1 -1 -1 -1 -1 -1 -1 -1 -1 -1 -1 -1 -1 -1 -1 -1 
-1 -1 -1 -1 -1 -1 -1 -1 -1 -1 -1 -1 -1 -1 -1 -1 -1 -1 -1 -1 -1 -1 -1 -1 -1 -1 -1 -1 -1 -1 
-1 -1 -1 -1 -1 -1 -1 -1 -1 -1 -1 -1 -1 -1 -1 -1 -1 -1 -1 -1 -1 -1 -1 -1 -1 -1 -1 -1 -1 -1 
-1 -1 -1 -1 -1 -1 -1 -1 -1 -1 -1 -1 -1 -1 -1 -1 -1 -1 -1 -1 -1 -1 -1 -1 -1 -1 -1 -1 -1 -1 
-1 -1 -1 -1 -1 -1 -1 -1 -1 -1 -1 -1 -1 -1 -1 -1 -1 -1 -1 -1 -1 -1 -1 -1 -1 -1 -1 -1 -1 -1 
Board auto-completed by AI
16 0 16 4 2 4 16 4 4 4 12 2 4 16 3 4 12 2 4 12 3 16 4 4 4 4 16 4 16 4 
4 4 16 3 16 0 16 16 4 4 4 16 3 16 4 16 4 16 4 4 12 4 4 4 16 4 4 12 2 4 
12 4 4 12 4 4 4 4 16 16 0 2 4 2 12 4 16 16 0 16 4 4 12 4 4 16 16 4 16 3 
4 16 4 4 16 16 16 3 16 16 4 16 3 16 4 4 4 4 4 4 16 16 4 4 12 4 4 12 2 12 
3 16 3 16 4 16 16 4 4 4 16 4 12 4 4 4 16 4 4 4 4 16 16 6 4 4 16 4 16 4 
4 2 4 2 4 2 16 16 16 4 16 16 4 4 4 4 4 4 4 16 4 4 4 4 4 12 2 4 2 4 
16 16 4 16 3 16 16 4 16 16 16 16 16 4 16 16 4 4 4 16 16 4 16 6 16 4 16 4 16 4 
2 4 12 4 4 2 2 4 2 4 16 16 4 4 16 16 4 4 12 4 4 4 16 4 2 12 2 12 2 4 
16 4 4 16 3 16 -1 -1 -1 -1 -1 -1 -1 -1 -1 -1 -1 16 4 4 4 4 4 16 16 4 16 4 16 4 
16 3 16 4 4 4 -1 -1 -1 -1 -1 -1 -1 -1 -1 -1 -1 4 4 4 4 4 16 16 16 16 4 16 16 4 
16 4 2 4 4 4 -1 -1 -1 -1 -1 -1 -1 -1 -1 -1 -1 4 4 4 4 4 4 2 4 2 12 2 4 4 
16 4 16 4 16 4 -1 -1 -1 -1 -1 -1 -1 -1 -1 -1 -1 16 6 0 16 4 4 16 16 16 4 16 4 4 
4 16 16 6 2 4 -1 -1 -1 -1 -1 -1 -1 -1 -1 -1 -1 16 4 4 4 4 4 16 4 16 0 16 4 4 
4 4 4 4 16 4 -1 -1 -1 -1 -1 -1 -1 -1 -1 -1 -1 4 16 16 0 16 0 16 0 16 4 16 0 16 
16 4 4 6 2 4 -1 -1 -1 -1 -1 -1 -1 -1 -1 -1 -1 4 16 16 6 2 4 4 4 4 16 16 12 4 
4 16 4 4 16 16 -1 -1 -1 -1 -1 -1 -1 -1 -1 -1 -1 6 16 16 4 16 16 4 4 4 16 16 4 16 
4 4 4 6 16 4 -1 -1 -1 -1 -1 -1 -1 -1 -1 -1 -1 12 2 4 4 12 4 3 16 4 4 4 4 4 
4 16 4 4 4 16 -1 -1 -1 -1 -1 -1 -1 -1 -1 -1 -1 0 16 4 16 4 4 12 2 12 4 3 16 4 
4 4 3 16 16 4 -1 -1 -1 -1 -1 -1 -1 -1 -1 -1 -1 4 4 16 4 4 16 4 16 4 4 12 2 12 
4 4 4 4 16 16 -1 -1 -1 -1 -1 -1 -1 -1 -1 -1 -1 16 4 16 4 4 2 4 16 16 4 4 16 4 
0 16 6 12 2 4 4 16 4 4 16 4 4 4 4 4 4 16 3 16 16 3 16 16 4 4 4 4 16 16 
4 4 4 4 16 4 16 16 0 16 16 3 16 16 4 4 16 4 4 16 4 12 2 4 4 16 6 4 2 4 
16 4 6 16 4 3 16 4 4 16 16 4 4 2 4 16 4 4 4 2 4 4 16 16 0 4 4 4 16 16 
4 4 4 16 16 4 4 4 16 16 16 0 16 16 16 4 4 4 4 16 4 4 16 16 4 4 4 4 4 4 
16 16 4 4 2 4 16 4 4 16 16 4 2 4 4 4 4 4 16 16 3 16 4 4 4 4 4 4 4 4 
16 4 16 16 16 12 2 4 4 4 4 4 16 4 4 4 4 16 16 16 12 4 4 16 3 16 6 12 3 16 
16 16 16 4 4 4 16 3 16 0 16 4 2 4 16 16 16 4 2 4 4 4 16 4 4 16 4 4 12 4 
16 4 16 3 12 12 2 4 4 4 16 3 16 16 16 16 16 3 16 6 4 4 16 4 4 4 16 16 4 16 
16 16 16 4 4 4 16 16 0 16 16 4 4 4 4 4 16 4 16 4 4 4 4 4 4 4 4 16 4 4 
4 2 4 4 16 12 2 4 4 16 4 16 6 4 4 4 2 12 4 4 16 0 16 4 4 4 4 16 4 4 

Asset Legend:
0 Chest
1 Column
2 Door Horizontal
3 Door Vertical
4 Floor Empty
5 Large Bush Square
6 Monster
7 SmallBush Round
8 SmallBush Square
9 Stairs Down
10 Stairs Up
11 Statue
12 Trap
13 Tree
14 Wall Cross
15 Wall Horizontal
16 Wall Thick
17 Wall Vertical
